-------2
11111111
--------
/
2-------
11111111