31013200
10110010
--------
/
2------3
44444444