-------2
33333333
--------
/
2-------
11111111