--------
---13---
--121---
33333333
/
21111111
111-1111
11130100
00000000